2222222222
2222222222
2001300402
2222222222
2222222222
2222222222
